{"turnsLimit": 600, "dogVisibilityR": 6, "dogBarkingR": 6, "sheepScaryTurns":6, "dogScaryTurns":6, "sheepStandBy": 2}
###...........
#--@..........
#--@..........
.@@@..........
..............
..............
..............
......*.......
..............
..............
..............
..............
..............
..............
..............