{"turnsLimit": 200, "dogVisibilityR": 6, "dogBarkingR": 4, "sheepScaryTurns":1, "dogScaryTurns":1, "sheepStandBy": 6}
..............
...*..........
........*.....
.*............
.....----..*..
.....----.....
..*..----.....
.....----..*..
.*....@.......
........*.....
....*.........
.......*......