....................
.*......*...........
................*...
....................
######..............
#----#..............
#----@............*.
#----#..............
######.......*......
....................
....................
....................
....................
..*.................
....................
..............*.....
....................
....................
...*..............*.
..........*.........
