.....................
.....................
.....................
.---..........*ooo*..
.---..........*ooo*..
.---..........*ooo*..
.@@..................
.....................
.....................