........
.#####..
.#**-#..
.#**-#..
.....@..