........
.#####..
.#oo-#..
.#oo-#..
.....@..