................................
................................
......*..........*.........*....
................................
......................*.........
.....*...*......................
..................*.............
...........#####..#####.........
....*......#----------#......*..
...........#----------#.........
...........@----------..........
...*........----------..........
...........#----------#.........
...........#----------#.......*.
...........#####..#####.........
....*...........................
.......................*........
........*.......................
................*.......*.......
...*............................
..........*..............*......
................................
...............*................