..........
..........
.######.@.
.#-o--#...
.#----#...
.######...
....@.....