.........................
#########################
.........................
#########################
.........................
.........................
##########ooooo##########
#.........-ooo-.........#
#.........-o@o-.........#
#.........-ooo-.........#
##########ooooo##########
.........................
#########################
.........................
.........................
#########################
.........................