..........
..........
..######..
..#-oo-#..
...-oo-...
..#-oo-#..
..######..
....@@....
..........
..........
